11101110111011101110111011101110111
10101010101010101010101010101010101
11111011101110111011101110111011101
00100010001000001000001000101000000
11101010111011111011101011101010111
10001010100000000000000000000010101
11101010100011101111101011101011101
00101000100010100000101010101000000
11101011101110101110101110111111101
10001010001000001000100000000000101
11111011101000111010101010001000111
00100000100000100010001010001000000
11101111101111100010111011101111111
10001000001000000000000000000000001
11101111111000000011111011111111111
00100000000000000000101010000000000
11100000111110111110101010101110001
10000000100000000010000000100010001
11101110111011101110111011101110111
00101010101010101010101010101010101
00111011101110111011101110111011101